# # # # # # # # # # # # # # #
# . . . # . . . . . . . . . #
# . # . # . # # # # # . # . #
# . # . # . . . . . # . # . #
. . # # # . # # # . # . # . #
# . . . # . # . # . # . . . #
# . # . # . # . # . # # # # #
# . # . . . # . # . . . . . #
# . # # # # # . # # # # # . #
# . . . # . . . . . . . # . #
# # # . # . # # # # # . # # #
# . . . . . # . . . . . # . .
# . # # # . # # # # # # # . #
# . . . # . . . . . . . . . #
# # # # # # # # # # # # # # #