# # # . # # # # # # # # # # #
# . # . # . . . . . . # . . #
# . # . # . # # # # . # # . #
# . # . . . . . . # . . . . #
# . . . # . # # # # # # # . #
# # # . # . # . . . # . . . #
# . . . # . # . # . # # # # #
# . # . . . # . # . . . . . #
# . # # # # # . # # # . # . #
# . . . # . . . . . . . # . #
# . # . # . # . # # # . # . #
# . # . . . # . . . . . # . #
# . # # # . # # # # # # # . .
# . . . # . . . . . . . . . #
# # # # # # # # # # # # # # #