# # # # # # # # # # # # # # #
# . . # . . # . . . . . . . #
# . . . . . # . # # # . . . #
# . . # . . # . . . # . . . #
# . . # # . # # # . # . . . .
# # # # . . # . . . # . . . #
# . . . . . # . # . # # # # #
# . # . . . # . # . . . . . #
# . # # # # # . # # # . . . #
# . . . # . . . . . # . . . #
# . . . # . # . . . # . # . #
. . . . . . # . . . . . # . #
# . . . # . # # # # # # # . #
# . . . # . . . . . . . . . #
# # # # # # # # # # # # # # #